122222222222222222222222222221
100000000000000000000000000001
100000000000000000000000000001
102200022200000000002220002201
100000000000000000000000000001
100000000000000000000000000001
100222200000222222000002222001
100000000000000000000000000001
100000000000000000000000000001
102222200022200002220002222201
100000000000000000000000000001
100000000000000000000000000001
122222222222222222222222222221